3 4 531 896 896 896 
3 7 8259 8239 8260 8240 8245 8232 8218 
1 8 8445 3406 2347 8420 1425 607 2648 8427 
1 13 8879 8849 3581 4636 8764 8728 8673 3534 431 8616 435 3682 5411 
1 4 435 8625 1879 8670 
1 2 2776 8879 
1 4 8829 1279 8799 8800 
1 2 8650 8603 
1 7 8603 8629 5495 3482 8587 8585 3682 
1 7 5495 5553 3819 8515 2841 8465 8445 
1 6 8445 3146 1923 8406 5131 8377 
1 12 1280 2759 4591 4047 4592 3962 4891 1568 449 2478 8382 8377 
2 15 1929 4805 4788 139 3276 8358 8343 4194 8301 8335 8323 8297 5347 8246 8218 
2 5 8323 1792 1407 8410 8427 
2 7 139 3837 8414 2987 8368 767 8346 
1 4 2987 1459 1298 8474 
1 8 8368 5474 8214 8177 8155 2046 2167 8154 
1 5 2046 1647 4953 4129 2988 
2 11 2988 7992 1409 3845 7966 7945 984 4039 3031 4258 7900 
3 3 8259 8276 8260 
1 2 8276 8239 
2 10 8218 2900 8234 1722 8151 8130 8107 8082 4657 8122 
1 6 4657 8063 8032 2293 7963 7960 
1 8 7960 1414 7906 7841 1251 7758 7739 7705 
1 10 7906 1657 3555 4248 7954 1494 7961 7964 2761 7998 
1 9 7998 4330 2400 7974 1313 2733 4889 8011 8043 
1 2 8048 5595 
1 9 2613 2387 8447 2088 4085 3583 1997 8348 4979 
1 9 2387 3787 4983 8396 595 8401 8415 3026 1843 
1 15 8287 3556 8200 8184 1757 8252 8293 5057 74 8327 551 8242 4288 8186 8152 
1 3 7996 4715 8051 
1 3 2580 7898 7887 
1 4 7662 7653 7637 7629 
1 2 7588 7593 
10 2 8567 8584 
10 2 3137 8584 
10 2 8599 8584 
10 3 8545 8584 8599 
7 5 1703 6874 10459 6845 6810 
7 5 6810 6735 6834 6820 6840 
7 4 6775 6769 3654 6810 
7 3 6769 10453 6716 
1 2 10453 3654 
6 10 6840 6859 90 6910 6932 10446 5639 3411 3971 4519 
6 10 6840 2627 6766 6714 10437 2804 5465 6543 3567 2141 
6 11 6840 6824 10443 6791 6800 3484 6839 3220 2071 1611 1383 
7 3 6874 6907 6922 
7 6 4746 2414 10458 931 6788 6775 
7 4 931 6841 6786 6845 
1 2 10459 6786 
7 3 10458 6897 6922 
7 4 6716 2789 6715 6695 
7 3 6766 6727 6715 
7 5 6716 5121 6700 6717 6669 
4 4 10462 6821 6828 6845 
4 4 10462 850 6866 3654 
4 3 850 5587 6775 
4 3 6821 6867 931 
1 2 1703 6910 
1 2 90 6824 
6 17 6910 3388 6921 3942 5415 6997 5190 2914 7061 10381 4509 2750 7174 7186 1205 7232 3974 
6 8 6770 6744 10450 6749 6724 1230 6763 6712 
7 5 6775 6762 6795 6787 6770 
7 4 6717 167 6754 6770 
1 2 6754 6744 
7 4 6787 6902 6877 4746 
7 27 6910 90 6824 6792 2114 6714 3558 6658 4759 6659 5345 4224 6660 6670 4349 6744 5221 4125 3016 4396 1663 6952 4782 6959 4477 6945 6932 
1 2 6922 4782 
1 2 4746 4396 
1 2 6669 4224 
1 2 6695 3558 
2 8 7061 7089 7103 7119 1299 2238 7120 4519 
3 6 7061 7028 6985 6926 535 1383 
5 63 6975 10382 10383 10385 10386 744 7149 10388 7143 10389 7140 10392 10394 7141 10395 10399 10400 540 10403 4271 10405 6999 10406 10410 10414 10415 197 10416 10417 6561 6536 6514 10418 10419 10422 10423 6498 10424 10426 10427 10430 889 10431 10432 10433 6388 1189 10363 6507 10362 6590 10361 10360 9348 9293 10366 10368 10369 6876 10372 10374 10375 10379 
1 3 10379 10381 6975 
1 2 1383 10368 
2 6 1383 6774 6711 6647 4951 1514 
1 9 2141 2264 4964 3724 5096 3436 4846 6437 1514 
1 2 2141 10426 
1 2 6437 1189 
1 2 6712 197 
1 11 6712 976 3914 4709 6535 4059 6452 4413 6422 6389 2141 
1 2 4519 7149 
1 5 6982 4191 3687 4252 6763 
2 9 4519 7114 4840 3339 4181 3073 2679 7037 6982 
1 5 5865 5885 5933 5944 5957 
1 5 5865 5851 5867 5915 5957 
4 2 563 6901 
3 12 563 6972 7056 7017 10451 7171 338 7201 2245 1586 334 7273 
2 4 7056 3414 7059 1744 
1 7 1744 7136 7176 3988 7235 809 2719 
4 5 3387 7487 7504 5346 7545 
2 10 3387 7451 7429 1669 3213 4909 7321 7293 1794 2719 
2 12 2719 1794 5470 7255 2384 935 3285 7177 2518 1339 3510 7160 
1 9 3285 3102 7093 1214 7005 2351 4334 3169 736 
1 5 736 2745 1389 5440 2471 
1 2 3169 2745 
2 6 6901 6894 6850 2523 4148 2471 
2 2 563 6894 
1 13 2471 3545 6588 315 1450 1817 5175 3692 2618 1601 1090 2133 1307 
1 8 4159 6768 6765 6699 4353 4329 4170 1307 
1 7 4159 6741 5339 1639 6600 523 2618 
1 11 1090 2 4273 4368 1262 4564 5644 6232 1127 5279 3723 
3 3 1206 3912 3167 
2 3 3167 1973 1872 
1 7 1872 7196 4491 1003 1680 621 6914 
2 2 6617 6640 
2 6 8591 856 8532 939 5349 8567 
2 7 5349 2276 2859 2879 8479 807 8429 
2 9 8429 2740 8366 5200 3707 1803 1095 8195 3439 
1 12 1803 3136 1806 1698 1068 3322 460 47 659 1685 3981 8014 
1 15 8479 2234 8457 408 1195 8413 699 8331 5651 4312 4835 2079 349 8064 8014 
4 7 5163 411 5511 1531 2568 2657 7609 
2 12 7609 7656 182 3597 1866 1584 2994 5301 7895 7923 1889 8014 
2 13 7696 4850 7707 4303 4880 3688 2525 5002 731 2500 4256 1454 7923 
1 2 2994 4256 
1 7 7255 852 7301 7311 2781 1587 3242 
1 8 4132 7318 4238 7305 7285 292 4938 7160 
1 5 7285 1884 2505 7329 2781 
1 10 4909 7358 7390 1135 788 7420 3861 7411 4190 1587 
1 6 4238 2790 4827 55 750 3101 
1 7 3242 7430 242 4686 7416 2438 750 
1 8 3242 4117 5399 7459 1141 3233 4003 851 
2 13 4433 7692 2598 7599 602 7583 7589 7572 700 7570 7550 3817 851 
2 7 4186 8041 3114 8095 8127 8166 8182 
2 8 4186 14 189 4633 3261 36 7885 4295 
2 7 4633 1991 7843 3144 2084 7740 4433 
2 5 5449 5211 1899 6836 6872 
2 8 5449 6873 3947 6849 6855 6805 4289 6648 
2 12 4867 5605 2341 738 6345 6401 4344 6541 4678 6654 106 5449 
2 13 5605 2922 6240 6225 6203 448 2149 6222 6251 172 2595 3811 1371 
2 3 172 3426 3418 
