3 7 8259 8239 8260 8240 8245 8232 8218 
1 8 8445 3406 2347 8420 1425 607 2648 8427 
1 13 8879 8849 3581 4636 8764 8728 8673 3534 431 8616 435 3682 5411 
1 4 435 8625 1879 8670 
1 2 2776 8879 
1 4 8829 1279 8799 8800 
1 2 8650 8603 
1 7 8603 8629 5495 3482 8587 8585 3682 
1 7 5495 5553 3819 8515 2841 8465 8445 
1 6 8445 3146 1923 8406 5131 8377 
1 12 1280 2759 4591 4047 4592 3962 4891 1568 449 2478 8382 8377 
2 15 1929 4805 4788 139 3276 8358 8343 4194 8301 8335 8323 8297 5347 8246 8218 
2 5 8323 1792 1407 8410 8427 
2 7 139 3837 8414 2987 8368 767 8346 
1 4 2987 1459 1298 8474 
1 8 8368 5474 8214 8177 8155 2046 2167 8154 
1 5 2046 1647 4953 4129 2988 
2 11 2988 7992 1409 3845 7966 7945 984 4039 3031 4258 7900 
3 3 8259 8276 8260 
1 2 8276 8239 
2 10 8218 2900 8234 1722 8151 8130 8107 8082 4657 8122 
1 6 4657 8063 8032 2293 7963 7960 
1 8 7960 1414 7906 7841 1251 7758 7739 7705 
1 10 7906 1657 3555 4248 7954 1494 7961 7964 2761 7998 
1 9 7998 4330 2400 7974 1313 2733 4889 8011 8043 
1 2 8048 5595 
1 9 2613 2387 8447 2088 4085 3583 1997 8348 4979 
1 9 2387 3787 4983 8396 595 8401 8415 3026 1843 
1 15 8287 3556 8200 8184 1757 8252 8293 5057 74 8327 551 8242 4288 8186 8152 
1 3 7996 4715 8051 
1 3 2580 7898 7887 
1 4 7662 7653 7637 7629 
1 2 7588 7593 
10 2 8567 8584 
10 2 3137 8584 
10 2 8599 8584 
10 3 8545 8584 8599 
7 5 1703 6874 10459 6845 6810 
7 5 6810 6735 6834 6820 6840 
7 4 6775 6769 3654 6810 
7 3 6769 10453 6716 
1 2 10453 3654 
6 10 6840 6859 90 6910 6932 10446 5639 3411 3971 4519 
6 10 6840 2627 6766 6714 10437 2804 5465 6543 3567 2141 
6 11 6840 6824 10443 6791 6800 3484 6839 3220 2071 1611 1383 
7 3 6874 6907 6922 
7 6 4746 2414 10458 931 6788 6775 
7 4 931 6841 6786 6845 
1 2 10459 6786 
7 3 10458 6897 6922 
7 4 6716 2789 6715 6695 
7 3 6766 6727 6715 
7 5 6716 5121 6700 6717 6669 
4 4 10462 6821 6828 6845 
4 4 10462 850 6866 3654 
4 3 850 5587 6775 
4 3 6821 6867 931 
1 2 1703 6910 
1 2 90 6824 
6 17 6910 3388 6921 3942 5415 6997 5190 2914 7061 10381 4509 2750 7174 7186 1205 7232 3974 
6 8 6770 6744 10450 6749 6724 1230 6763 6712 
7 5 6775 6762 6795 6787 6770 
7 4 6717 167 6754 6770 
1 2 6754 6744 
7 4 6787 6902 6877 4746 
7 27 6910 90 6824 6792 2114 6714 3558 6658 4759 6659 5345 4224 6660 6670 4349 6744 5221 4125 3016 4396 1663 6952 4782 6959 4477 6945 6932 
1 2 6922 4782 
1 2 4746 4396 
1 2 6669 4224 
1 2 6695 3558 
2 8 7061 7089 7103 7119 1299 2238 7120 4519 
3 6 7061 7028 6985 6926 535 1383 
5 63 6975 10382 10383 10385 10386 744 7149 10388 7143 10389 7140 10392 10394 7141 10395 10399 10400 540 10403 4271 10405 6999 10406 10410 10414 10415 197 10416 10417 6561 6536 6514 10418 10419 10422 10423 6498 10424 10426 10427 10430 889 10431 10432 10433 6388 1189 10363 6507 10362 6590 10361 10360 9348 9293 10366 10368 10369 6876 10372 10374 10375 10379 
1 3 10379 10381 6975 
1 2 1383 10368 
2 6 1383 6774 6711 6647 4951 1514 
1 9 2141 2264 4964 3724 5096 3436 4846 6437 1514 
1 2 2141 10426 
1 2 6437 1189 
1 2 6712 197 
1 11 6712 976 3914 4709 6535 4059 6452 4413 6422 6389 2141 
1 2 4519 7149 
1 5 6982 4191 3687 4252 6763 
2 9 4519 7114 4840 3339 4181 3073 2679 7037 6982 
1 5 5865 5885 5933 5944 5957 
1 5 5865 5851 5867 5915 5957 
4 2 563 6901 
3 12 563 6972 7056 7017 10451 7171 338 7201 2245 1586 334 7273 
2 4 7056 3414 7059 1744 
1 7 1744 7136 7176 3988 7235 809 2719 
4 5 3387 7487 7504 5346 7545 
2 10 3387 7451 7429 1669 3213 4909 7321 7293 1794 2719 
2 12 2719 1794 5470 7255 2384 935 3285 7177 2518 1339 3510 7160 
1 9 3285 3102 7093 1214 7005 2351 4334 3169 736 
1 5 736 2745 1389 5440 2471 
1 2 3169 2745 
2 6 6901 6894 6850 2523 4148 2471 
2 2 563 6894 
1 13 2471 3545 6588 315 1450 1817 5175 3692 2618 1601 1090 2133 1307 
1 8 6682 1949 6708 6699 4353 4329 4170 1307 
1 8 2618 523 6600 1639 5339 6682 6741 4159 
1 11 1090 2 4273 4368 1262 4564 5644 6232 1127 5279 3723 
3 3 1206 3912 3167 
2 3 3167 1973 1872 
1 7 1872 7196 4491 1003 1680 621 6914 
2 2 6617 6640 
2 6 8591 856 8532 939 5349 8567 
2 7 5349 2276 2859 2879 8479 807 8429 
2 9 8429 2740 8366 5200 3707 1803 1095 8195 3439 
1 12 1803 3136 1806 1698 1068 3322 460 47 659 1685 3981 8014 
1 15 8479 2234 8457 408 1195 8413 699 8331 5651 4312 4835 2079 349 8064 8014 
4 7 5163 411 5511 1531 2568 2657 7609 
2 12 7609 7656 182 3597 1866 1584 2994 5301 7895 7923 1889 8014 
2 13 7696 4850 7707 4303 4880 3688 2525 5002 731 2500 4256 1454 7923 
1 2 2994 4256 
1 7 7255 852 7301 7311 2781 1587 3242 
1 8 4132 7318 4238 7305 7285 292 4938 7160 
1 5 7285 1884 2505 7329 2781 
1 10 4909 7358 7390 1135 788 7420 3861 7411 4190 1587 
1 6 4238 2790 4827 55 750 3101 
1 7 3242 7430 242 4686 7416 2438 750 
1 8 3242 4117 5399 7459 1141 3233 4003 851 
2 13 4433 7692 2598 7599 602 7583 7589 7572 700 7570 7550 3817 851 
2 7 4186 8041 3114 8095 8127 8166 8182 
2 8 4186 14 189 4633 3261 36 7885 4295 
2 7 4633 1991 7843 3144 2084 7740 4433 
2 5 5449 5211 1899 6836 6872 
2 8 5449 6873 3947 6849 6855 6805 4289 6648 
2 12 4867 5605 2341 738 6345 6401 4344 6541 4678 6654 106 5449 
2 13 5605 2922 6240 6225 6203 448 2149 6222 6251 172 2595 3811 1371 
2 3 172 3426 3418 
1 2 8259 1084 
1 9 604 3604 8278 4987 5129 8403 8417 8437 3962 
1 4 1307 4795 6478 5240 
1 11 6790 4641 4934 6764 6772 6779 6783 6806 2219 6780 6807 
1 8 6780 3851 6837 6856 6905 1649 4607 7007 
1 10 6780 6746 6694 2005 585 4266 5615 1527 6417 5240 
1 6 6752 4681 2356 420 1505 5240 
1 10 4327 7110 3007 7097 1564 6991 6929 3713 1064 6752 
1 8 4327 7096 4876 4394 4638 7081 3508 7007 
1 9 6790 3029 5441 6812 4400 4958 6652 969 2378 
1 4 2378 5169 6402 257 
1 8 257 3906 3877 124 2899 2727 6272 5605 
1 3 4392 6289 6240 
1 4 6225 6180 2491 2236 
1 12 1013 5004 43 5219 6148 6138 3382 6121 6117 6131 6134 2236 
1 5 6218 2019 609 6162 6148 
1 4 1013 6187 488 609 
1 7 6187 6190 3472 2854 1002 4971 388 
1 5 3723 3987 2866 6172 388 
1 5 257 3746 4669 4376 2854 
1 10 6417 2892 6328 1709 2233 1017 1919 915 3455 3746 
1 4 585 2490 5650 1919 
1 5 1709 6305 2760 4052 3723 
1 4 6218 6239 6276 2899 
1 6 6648 4483 32 1683 1396 3906 
1 3 3193 3392 6192 
1 6 9182 3563 3606 1519 3939 5327 
1 12 2321 5123 9132 9137 4478 2732 9146 9139 9149 9156 3530 9182 
1 5 5327 9042 2527 9089 4478 
1 5 1519 712 3479 831 4306 
1 5 4306 3266 651 1642 3127 
1 10 3127 1706 8980 3360 4328 8840 1763 8763 1374 2921 
1 12 8980 1320 8968 2180 9056 698 4734 9005 8993 3559 2601 3841 
1 4 3841 573 2710 1093 
1 5 1093 4874 1907 17 5251 
1 7 2243 8886 3140 359 67 8845 17 
1 7 2243 8954 739 1905 401 5487 922 
1 4 9181 3617 3928 922 
1 2 5487 3928 
1 9 9181 9206 1179 9195 9214 9228 1143 9229 9251 
1 9 573 4877 1110 9117 1211 9193 1530 9248 9251 
1 6 1211 4476 709 9285 2927 2154 
1 5 709 943 9277 3143 9248 
1 7 4306 9070 1533 3198 9172 389 2971 
1 4 389 2175 9167 620 
1 7 620 9127 3265 713 5481 1927 9056 
1 7 2321 9202 9218 1627 9250 9256 3524 
1 5 3524 3095 1982 3112 980 
1 2 3095 9250 
1 4 980 9078 3758 2757 
1 6 980 4604 9094 2816 9054 9036 
1 6 2321 9148 2404 1410 4172 8997 
1 4 2404 4227 1716 980 
1 10 8997 925 4578 9037 9033 2911 5006 3225 5317 5327 
1 7 9284 9291 4844 3773 2751 3289 2971 
1 5 3289 2486 9302 3872 615 
1 7 615 5502 9371 9368 9344 9314 9284 
1 7 8182 8201 1818 1614 1597 1308 3573 
1 10 3573 4526 1162 3130 1860 7950 468 1070 2320 7915 
1 6 1162 1695 3551 997 2704 4295 
1 8 7915 5044 4981 3627 2358 2675 1132 7696 
1 10 2358 901 3433 4632 1027 7535 1265 7477 755 7430 
1 11 1070 1681 7848 3973 5357 1480 4223 2313 3980 3033 3817 
1 7 698 5132 3943 630 8756 8692 8775 
1 3 2243 4350 8837 
1 11 3140 1304 8837 3566 8792 211 4613 4817 3764 8669 8647 
1 4 4817 362 103 8563 
1 7 1823 8687 8665 4263 871 2803 8647 
1 8 871 692 5655 8497 1969 4901 8448 8416 
1 6 1969 3903 8455 941 1787 8563 
1 8 941 194 8441 477 8269 1366 2272 8134 
1 13 3597 7751 1727 7687 2260 3744 3983 5372 7579 7563 4021 2178 2107 
1 9 3229 4600 3457 282 7507 273 3068 7521 2107 
1 4 3133 169 3172 707 
1 10 3088 4654 2877 4044 1715 3557 72 6674 1925 3133 
1 6 3557 6578 3767 6383 3215 1556 
1 4 1556 6245 1043 6205 
1 6 7101 2724 101 2103 6784 707 
1 6 7101 2218 7073 643 2503 5570 
1 14 2503 2345 4584 458 1760 5326 3131 6513 4860 6426 6375 3325 6316 96 
1 5 96 6273 1510 1297 3193 
1 12 3193 1187 5401 6129 6128 2226 911 3385 4030 160 6110 6105 
1 9 6105 4424 4308 6099 2864 6089 1491 6080 6086 
1 6 6086 4325 6090 6083 6078 6075 
1 4 6068 4920 6081 6075 
1 10 3088 5555 6645 4337 1089 1644 6410 5102 4417 6436 
1 10 4417 556 3924 6248 3205 3933 1231 1856 6201 1202 
1 8 1202 1289 973 6198 2095 6254 929 5033 
1 3 973 2151 3399 
1 8 3399 5314 2513 1493 6145 2472 6154 1741 
1 3 2095 2464 1493 
1 6 6199 1275 6214 6202 361 1741 
1 10 7149 7187 7213 1 333 3614 808 7389 406 7473 
1 6 7473 662 7515 2534 817 3677 
1 6 3677 3710 7448 2024 7395 1942 
1 14 1942 5115 1059 735 7205 3125 1401 1735 4061 7252 7277 193 7270 2348 
1 11 1942 195 7308 4160 7295 3854 7320 4871 1160 7332 7337 
1 11 1310 8198 3027 8140 8108 8079 2883 8065 8021 190 3441 
1 7 3441 1054 2126 801 3836 1227 4737 
1 16 2126 2960 7793 176 1522 2670 2655 3298 2331 956 91 7444 7415 945 7341 7337 
1 13 2882 5425 5155 8976 8987 8990 8992 152 9020 4092 4694 9122 1886 
1 3 785 687 1886 
1 12 5597 4811 9267 9261 805 9312 9339 9364 2386 1990 419 9418 
1 8 45 2609 2002 2451 9664 9690 2330 9691 
1 14 9691 4902 5427 2205 9698 5225 3342 3077 2492 4379 1022 9541 252 9538 
1 4 9319 9309 9322 2962 
1 7 9556 940 9609 3740 9694 9695 9722 
1 2 2399 8126 
1 3 7618 7625 7610 
1 8 6585 4076 6524 2951 5652 6419 6468 6423 
1 9 5963 5540 5968 5258 4013 5908 5902 1350 5898 
1 6 5810 5826 5829 5854 2150 5898 
1 7 5733 5750 5756 5781 5804 5791 5810 
1 12 5810 1175 5795 1857 5758 5778 3061 305 5796 5811 5818 5834 
1 3 5865 5859 5823 
1 5 5823 2682 5807 5785 5770 
1 6 2682 5801 5837 5822 2969 4714 
1 7 5930 678 5853 4628 3008 5821 4714 
1 9 4428 6005 5992 5981 4515 5958 5952 3053 5923 
1 2 5858 5391 
1 11 4428 6006 2907 5994 5466 1554 4947 5955 5917 5330 5887 
1 8 10316 1992 3258 10306 4046 10259 1044 10256 
1 3 10078 10061 10040 
1 9 10122 2945 764 10156 10163 243 3438 10196 10172 
1 14 3037 2405 10185 201 10208 4126 10168 10165 10167 10182 10174 5478 10173 10169 
1 7 9979 972 2449 10057 10105 10155 10185 
1 15 2531 9997 9985 2659 4530 4733 9967 2538 9975 10006 9988 9996 10022 1770 10057 
1 9 10176 10151 10130 10110 995 10088 10087 4722 2531 
1 3 1386 10186 5351 
1 3 10009 10029 10053 
1 3 10065 10046 10053 
1 6 411 4732 7470 1892 3253 7440 
1 8 4880 7647 51 2793 4026 1066 982 7440 
1 2 51 4495 
1 5 5357 2204 5420 2810 4632 
1 7 6640 1759 4107 6622 412 2735 4678 
